7 7 7 7 7 7 7 7 7 7 7 7 7 7 7 7 7 7 7 7 7 7 7 7 7 7 7 7 4 6 4 4 6 6 4 2 2 2 2 2 2 2 2 2 2 2 2 2 2 2 2 2 2 2 2 2 2 2 2 2
7 9 9 9 9 9 9 9 9 7 9 9 9 9 9 9 9 9 9 9 9 9 9 9 9 9 9 7 1 1 1 1 1 0 0 2 2 2 2 2 2 2 2 2 2 2 2 2 2 2 2 2 2 2 2 2 2 2 2 2 
7 9 7 7 9 7 7 7 7 7 7 7 7 7 7 7 7 7 7 7 7 7 7 7 7 7 9 7 1 1 1 0 0 0 2 2 2 2 2 2 2 2 2 2 2 2 2 2 2 2 2 2 2 2 2 2 2 2 2 2 
7 9 7 7 9 9 9 9 9 9 9 9 9 9 9 9 9 9 9 9 9 9 9 9 9 9 9 7 1 1 0 0 2 2 2 2 2 2 2 2 2 2 2 2 2 2 2 2 2 2 2 2 2 2 2 2 2 2 2 2  
7 9 7 7 7 7 7 7 7 7 7 7 7 9 9 7 7 7 7 7 7 7 7 7 7 7 9 7 1 1 0 0 2 2 2 2 2 2 2 2 2 2 2 2 2 2 2 2 2 2 2 2 2 2 2 2 2 2 2 2 
7 9 7 9 9 9 9 9 9 9 9 9 9 9 9 9 9 9 9 9 9 9 7 7 7 7 9 7 1 1 1 0 0 2 2 2 2 2 2 2 2 2 2 2 2 2 2 2 2 2 2 2 2 2 2 2 2 2 2 2 
7 9 7 9 7 7 7 7 7 7 7 7 7 9 7 7 7 7 7 7 7 9 7 7 7 7 9 7 1 1 1 1 0 0 0 0 2 2 2 2 2 2 2 2 2 2 2 2 2 2 2 2 2 2 2 2 2 2 2 2
7 9 7 9 7 9 9 9 7 9 9 9 7 9 7 7 7 7 7 7 7 9 9 9 9 7 9 7 1 1 1 1 1 1 0 0 2 2 2 2 2 2 2 2 2 2 2 2 2 2 2 2 2 2 2 2 2 2 2 2
7 9 7 9 7 9 7 9 7 9 7 9 7 9 9 9 9 9 9 9 7 9 7 7 9 7 9 7 7 7 7 1 1 1 1 0 0 0 2 2 2 2 2 2 2 2 2 2 2 2 2 2 2 2 2 2 2 2 2 2 
7 9 7 7 7 9 7 9 7 9 7 9 7 9 7 7 7 7 7 9 7 9 7 7 9 7 9 9 9 9 7 1 1 1 1 1 1 0 0 2 2 2 2 2 2 2 2 2 2 2 2 2 2 2 2 2 2 2 2 2  
7 9 7 9 9 9 7 9 9 9 7 9 7 7 7 7 7 7 7 7 7 7 7 7 9 7 9 9 9 9 7 1 1 1 1 1 1 1 0 0 2 2 2 2 2 2 2 2 2 2 2 2 2 2 2 2 2 2 2 2 
7 9 7 9 7 7 7 7 7 7 7 9 9 9 9 9 9 9 9 9 9 9 9 9 9 7 9 7 9 9 7 1 1 1 1 1 1 1 1 0 0 0 2 2 2 2 2 2 2 2 2 2 0 0 0 0 0 2 2 2 
7 9 7 9 7 7 9 7 9 9 9 7 9 7 7 7 7 7 7 7 7 7 7 7 7 7 9 7 9 9 7 1 1 1 7 7 7 7 7 7 0 0 2 2 2 2 2 2 2 2 0 0 0 0 1 1 0 0 0 2 
7 9 7 9 7 7 9 7 9 7 9 7 9 7 9 9 9 9 9 9 9 9 7 9 9 9 9 7 9 9 7 1 1 5 7 8 8 8 8 7 0 0 2 2 2 2 2 2 2 0 0 1 1 1 1 1 1 1 1 4 
7 9 7 9 7 7 9 7 9 7 9 7 9 7 9 7 7 7 7 7 7 7 7 9 9 9 9 7 7 7 7 1 1 5 8 8 8 8 8 7 0 0 0 0 2 2 2 2 2 2 0 0 1 1 1 1 1 1 1 4 
7 9 7 9 7 7 9 9 9 7 9 9 9 7 9 7 9 9 9 9 9 9 9 9 7 7 7 7 1 1 1 1 5 5 7 8 8 8 8 7 0 0 0 2 2 2 2 2 2 0 0 1 1 1 1 1 1 6 1 4 
7 9 7 9 9 9 7 7 7 7 7 7 7 7 9 7 9 7 7 7 7 7 7 9 7 1 1 1 1 1 5 5 5 1 7 7 7 7 7 7 0 0 2 2 2 2 2 2 0 0 1 1 1 4 4 1 1 1 1 4 
7 9 7 7 7 9 9 9 7 9 9 9 9 9 9 7 9 7 9 9 9 9 7 9 7 1 1 1 5 5 5 1 1 14 17 17 17 19 0 0 0 12 2 2 2 2 2 2 0 0 1 1 1 1 1 1 1 1 1 4 
7 9 9 9 7 7 7 9 7 7 7 7 7 7 9 7 9 7 9 7 7 7 7 9 7 1 1 1 5 1 1 1 14 18 2 2 2 20 0 0 0 12 2 2 2 2 2 2 0 0 1 1 1 1 1 6 1 1 1 4 
7 7 7 7 7 9 7 9 9 9 9 9 9 7 9 7 7 7 9 7 9 9 9 9 7 1 1 1 5 1 1 14 18 2 2 2 2 21 17 17 17 18 2 2 2 2 2 0 0 1 1 1 1 1 1 1 1 1 1 4 
7 7 9 9 9 9 9 9 9 9 9 9 9 7 9 9 9 7 9 7 9 7 7 7 7 1 1 5 5 1 0 12 2 2 2 2 2 2 2 2 2 2 2 2 2 2 2 2 0 0 1 1 1 4 1 1 1 1 1 4 
7 7 9 7 7 7 7 7 9 7 7 7 7 7 9 7 9 9 9 7 9 7 1 1 1 1 1 5 1 1 0 12 2 2 2 2 2 2 2 2 2 2 2 2 2 2 2 2 0 0 1 1 1 1 4 4 1 1 1 4 
7 7 9 7 9 9 9 9 9 7 9 9 9 9 9 7 9 7 9 7 9 7 1 1 5 5 5 5 1 1 0 12 2 2 2 2 2 2 2 2 2 2 2 2 2 2 0 0 0 1 1 1 1 1 1 1 1 1 1 4 
7 7 9 7 7 7 7 7 7 7 7 9 7 7 7 7 9 7 7 7 9 7 1 1 5 1 1 1 1 0 0 12 2 2 2 2 2 2 2 2 0 0 0 0 0 0 0 1 1 1 1 1 1 1 1 1 1 1 1 4 
7 7 9 9 9 9 9 9 9 9 7 9 9 9 9 9 9 9 9 9 9 7 1 1 5 1 1 1 14 17 17 18 2 2 2 2 2 2 0 0 0 1 1 1 1 1 1 1 1 1 1 1 1 1 1 1 1 1 1 4 
7 7 7 7 7 7 7 7 7 9 7 7 7 7 7 7 9 7 7 9 9 7 1 1 5 1 1 1 12 2 2 2 2 2 2 2 2 2 0 0 1 1 1 1 1 1 1 1 1 4 4 4 4 1 1 1 1 1 1 4 
7 7 7 7 7 7 7 7 7 9 9 9 9 9 9 7 9 7 7 7 9 7 1 1 5 1 1 1 12 2 2 2 2 2 2 2 2 2 0 0 1 1 1 1 1 1 1 1 1 1 1 1 1 1 1 1 1 1 1 4 
7 9 9 9 9 9 9 9 7 7 7 9 9 9 9 7 9 9 9 7 7 7 1 1 5 1 1 1 12 2 2 2 2 2 2 2 2 2 0 0 1 1 1 4 4 1 1 1 1 1 1 11 11 11 11 11 11 1 1 4 
7 7 7 7 7 7 7 9 7 9 7 9 9 9 9 7 9 7 7 7 1 1 5 5 5 1 14 17 18 2 2 2 2 2 2 2 0 0 0 1 1 1 1 1 4 4 1 1 1 4 1 11 8 8 8 8 11 1 1 4 
4 1 1 1 1 1 7 9 7 9 7 9 9 9 9 7 9 7 1 1 5 5 5 1 1 1 12 2 2 2 2 2 2 2 0 0 0 1 1 1 4 1 1 1 1 1 5 5 5 5 5 8 8 8 8 8 11 1 1 4 
4 1 1 1 1 1 7 9 7 9 7 7 7 7 7 7 9 7 1 1 5 1 1 14 17 17 18 2 2 2 2 2 0 0 0 1 1 1 1 1 1 1 1 1 5 5 5 5 1 1 1 11 8 8 8 8 11 1 1 4 
6 1 1 1 1 1 7 9 9 9 9 9 9 9 9 9 9 7 1 5 5 1 0 12 2 2 2 2 2 2 2 0 0 0 1 1 1 1 1 1 1 4 4 1 5 5 1 1 1 4 1 11 11 11 11 11 11 1 1 4 
4 1 1 1 1 1 7 7 7 7 7 7 7 7 9 7 7 7 1 5 1 1 0 12 2 2 2 2 2 2 2 0 0 1 1 1 1 1 1 1 1 1 1 1 5 1 1 1 1 1 1 1 1 1 1 1 1 1 1 4 
6 1 1 1 1 1 1 1 1 1 1 1 1 1 5 1 1 1 1 5 1 1 0 12 2 2 2 2 2 2 2 0 0 1 1 1 1 1 1 1 1 1 1 1 5 1 1 4 4 1 1 1 4 4 4 4 4 4 1 4 
6 1 1 1 1 1 1 1 1 1 1 1 1 1 5 1 1 1 1 5 1 1 0 12 2 2 2 2 2 2 2 0 0 1 1 1 1 4 4 1 4 4 1 1 5 1 1 1 1 1 1 1 1 1 1 1 1 1 1 4 
4 1 1 1 1 1 1 1 1 1 1 1 1 1 5 1 1 1 1 5 1 1 0 12 2 2 2 2 2 2 0 0 1 1 1 1 1 1 1 1 1 1 1 5 5 1 1 4 4 1 1 1 1 11 11 11 11 11 11 4 
6 1 1 1 4 6 1 1 1 1 1 5 5 5 5 5 5 5 5 5 5 5 5 3 3 3 3 3 3 3 5 5 5 5 5 5 5 5 5 5 5 5 5 5 5 1 4 4 4 1 1 1 1 11 8 8 8 8 11 4 
4 1 1 1 1 1 1 1 1 1 1 5 1 1 1 1 1 1 1 1 1 1 15 12 2 2 2 2 2 2 0 0 1 1 1 1 1 1 1 1 4 4 1 5 5 1 4 4 1 1 1 1 1 8 8 8 8 8 11 4 
4 1 1 1 1 1 4 6 1 1 1 5 1 4 1 1 1 1 1 1 1 1 15 13 2 2 2 2 2 2 2 0 0 0 1 1 1 1 1 4 4 4 1 5 5 1 1 1 1 1 1 1 1 11 8 8 8 8 11 4 
6 1 1 1 1 1 1 1 1 1 1 5 1 1 1 1 1 1 1 1 1 1 15 16 2 2 2 2 2 2 2 2 2 0 0 1 1 1 1 1 1 4 1 5 5 5 1 1 1 11 11 11 11 11 11 11 11 11 11 4 
4 1 1 1 1 1 1 1 1 1 1 5 1 1 1 1 1 1 1 1 1 1 1 23 0 12 2 2 2 2 2 2 2 0 0 1 1 4 4 1 1 1 5 5 5 5 5 5 1 11 8 8 8 8 8 8 8 8 11 4 
6 1 1 1 1 1 1 1 1 1 1 5 1 4 1 1 1 1 1 1 1 1 1 15 0 12 2 2 2 2 2 2 2 0 0 1 1 4 4 1 1 5 5 1 1 1 1 5 5 11 8 8 8 8 8 8 8 8 11 4 
4 1 1 1 1 4 5 5 5 5 5 5 5 5 5 5 5 1 1 1 1 1 1 15 0 12 2 2 2 2 2 2 2 0 0 1 1 1 1 1 1 5 1 1 4 4 1 5 5 8 8 8 8 8 8 8 8 8 11 4 
6 1 1 1 1 1 1 1 1 5 5 5 1 1 1 5 5 5 5 6 1 1 1 24 0 12 2 2 2 2 2 2 2 0 0 1 1 1 1 5 5 5 1 4 4 4 1 5 5 11 8 8 8 8 8 8 8 8 11 4 
4 1 1 1 1 4 1 1 5 5 1 5 5 1 1 4 1 1 1 1 1 1 15 0 14 18 2 2 2 2 2 2 2 0 0 1 1 1 1 1 5 1 1 1 1 1 1 1 1 11 8 8 8 8 8 8 8 8 11 4 
4 1 1 1 1 1 1 4 5 1 1 1 5 5 1 1 1 1 1 1 1 25 24 0 12 2 2 2 2 2 2 2 0 0 1 1 1 1 11 11 8 11 11 1 1 1 1 1 1 11 11 11 11 11 11 11 11 11 11 4 
6 1 1 1 1 1 1 5 5 1 1 1 1 1 1 1 1 1 1 1 15 0 0 0 12 2 2 2 2 2 2 2 0 0 1 1 1 1 11 8 8 8 11 1 1 1 4 4 1 1 1 1 1 1 1 1 1 1 1 4 
4 1 1 1 1 1 5 5 1 1 1 1 1 1 1 1 1 1 1 1 0 0 0 14 18 2 2 2 2 2 2 2 0 0 1 1 1 1 11 8 8 8 11 1 1 4 4 4 4 4 4 1 1 1 1 1 1 1 1 4 
6 1 1 4 4 1 1 1 1 1 1 1 1 1 1 1 1 1 1 14 17 17 18 2 2 2 2 2 2 2 2 2 0 0 1 1 1 1 11 8 8 8 11 1 1 1 1 1 4 4 1 1 1 1 1 1 1 0 0 4 
6 1 1 1 1 1 1 1 1 6 4 1 1 1 1 1 1 1 0 12 2 2 2 2 2 2 2 2 2 2 2 2 2 0 0 0 1 1 11 11 11 11 11 1 1 1 1 1 1 1 1 1 1 1 0 0 0 0 0 2 
4 1 1 1 1 1 1 1 1 1 4 1 1 1 1 1 1 1 0 12 2 2 2 2 2 2 2 2 2 2 2 2 2 0 0 0 0 1 1 1 1 1 1 1 1 1 1 1 1 1 1 1 1 0 0 0 2 2 2 2 
6 1 1 1 1 14 17 19 1 1 1 1 1 1 1 1 1 14 17 18 2 2 2 2 2 2 2 2 2 2 2 2 2 0 0 0 0 0 0 0 0 0 0 0 0 0 0 0 0 0 0 0 0 0 0 2 2 2 2 2
4 1 1 1 14 18 2 21 22 1 1 1 1 1 1 1 14 18 2 2 2 2 2 2 2 2 2 2 2 2 2 2 2 2 2 2 0 0 0 0 0 0 0 0 0 0 0 0 0 0 0 0 0 2 2 2 2 2 2 2 
4 1 1 14 18 2 2 2 20 1 1 1 1 1 1 1 12 2 2 2 2 2 2 2 2 2 2 2 2 2 2 2 2 2 2 2 2 2 2 2 2 2 2 2 2 2 2 2 2 2 2 2 2 2 2 2 2 2 2 2
6 1 1 12 2 2 2 2 20 1 1 1 1 1 1 14 18 2 2 2 2 2 2 2 2 2 2 2 2 2 2 2 2 2 2 2 2 2 2 2 2 2 2 2 2 2 2 2 2 2 2 2 2 2 2 2 2 2 2 2
6 1 1 12 2 2 2 2 20 0 0 1 1 1 14 18 2 2 2 2 2 2 2 2 2 2 2 2 2 2 2 2 2 2 2 2 2 2 2 2 2 2 2 2 2 2 2 2 2 2 2 2 2 2 2 2 2 2 2 2 
4 1 0 12 2 2 2 2 21 17 17 17 17 17 18 2 2 2 2 2 2 2 2 2 2 2 2 2 2 2 2 2 2 2 2 2 2 2 2 2 2 2 2 2 2 2 2 2 2 2 2 2 2 2 2 2 2 2 2 2
4 17 17 18 2 2 2 2 2 2 2 2 2 2 2 2 2 2 2 2 2 2 2 2 2 2 2 2 2 2 2 2 2 2 2 2 2 2 2 2 2 2 2 2 2 2 2 2 2 2 2 2 2 2 2 2 2 2 2 2
2 2 2 2 2 2 2 2 2 2 2 2 2 2 2 2 2 2 2 2 2 2 2 2 2 2 2 2 2 2 2 2 2 2 2 2 2 2 2 2 2 2 2 2 2 2 2 2 2 2 2 2 2 2 2 2 2 2 2 2
2 2 2 2 2 2 2 2 2 2 2 2 2 2 2 2 2 2 2 2 2 2 2 2 2 2 2 2 2 2 2 2 2 2 2 2 2 2 2 2 2 2 2 2 2 2 2 2 2 2 2 2 2 2 2 2 2 2 2 2